12 12
|==========|
|........#.|
|...=..=...|
|...=..=...|
|...=..=...|
|.....@....|
|=..====..=|
|...=......|
|..====...=|
|.....=....|
|...=..#...|
|==========|